{
    "mapa1": [
        "################",
        "#0...#..#..#..###",
        "#.##.0.###.....#",
        "#.##.#...0...###",
        "##.....#####...#", 
        "#..###.......###",
        "#..0...###....1#",
        "################"
    ],
    "mapa2": [
        "################",
        "#0...#..#..#..###",
        "#.##.0.###.....#",
        "#.##.#...0...###",
        "##...1.#####...#",
        "#..###.......###",
        "#..0...###.....#",
        "################"
    ],
    "mapa3": [
        "################",
        "#0...#..#..#..###",
        "#.##.0.###.....#",
        "#.##.#...0...###",
        "##.....#####...#",
        "#..###.......###",
        "#1.0...###.....#",
        "################"
    ]
}